10 10
##########
#        #
#        #
#        #
#   @    #
#   Z    #
#        #
#        #
#        #
##########