10 10
##########
#   T    #
#        #
#        #
#   $    #
#   @    #
#        #
#        #
#   T    #
##########