10 10
##########
#        #
#  S   W #
#        #
#  B     #
#  X     #
#@ B $   #
#  X     #
#E     N #
##########
