10 10
##########
#        #
#        #
#        #
#        #
#X       #
#@#  $   #
#X       #
#        #
##########
